{
    "height": 81,
    "width": 81,
    "player_start_row": 80,
    "player_start_col": 42,
    "data":
    [
      4, 20, 20, 20, 20, 20, 20, 20, 20, 20, 20, 20, 20, 20, 20, 20, 20, 20, 20, 20, 20, 20, 20, 20, 20, 20, 20, 20, 20, 20, 20, 20, 20, 20, 20, 20, 9, 27, 27, 27, 10, 20, 20, 20, 20, 20, 20, 20, 20, 20, 20, 20, 20, 20, 20, 20, 20, 20, 20, 20, 20, 20, 20, 20, 20, 20, 20, 20, 20, 20, 20, 20, 20, 20, 20, 20, 20, 20, 20, 20, 5,
      9, 25, 25, 25, 25, 25, 25, 25, 25, 25, 25, 25, 25, 25, 25, 25, 6, 25, 25, 25, 25, 25, 25, 25, 6, 25, 25, 25, 26, 25, 25, 25, 25, 25, 25, 25, 25, 25, 25, 25, 25, 25, 25, 25, 6, 25, 25, 25, 25, 25, 25, 25, 25, 25, 25, 25, 6, 25, 25, 25, 25, 25, 25, 25, 25, 25, 25, 25, 25, 25, 25, 25, 25, 25, 25, 25, 25, 25, 25, 25, 10,
      9, 25, 25, 25, 25, 25, 25, 25, 25, 25, 25, 25, 25, 25, 24, 25, 11, 25, 25, 25, 25, 25, 25, 25, 11, 25, 25, 25, 25, 25, 25, 25, 25, 25, 25, 25, 25, 25, 25, 25, 25, 25, 25, 25, 11, 25, 25, 25, 25, 25, 25, 25, 25, 25, 25, 25, 11, 25, 25, 25, 25, 25, 25, 25, 25, 25, 25, 25, 25, 25, 25, 25, 25, 25, 25, 25, 25, 25, 25, 25, 10,
      9, 25, 25, 25, 25, 25, 25, 25, 25, 25, 25, 25, 25, 25, 25, 25, 11, 25, 25, 25, 25, 25, 25, 25, 11, 25, 25, 25, 25, 25, 25, 25, 25, 25, 25, 25, 25, 25, 25, 25, 25, 25, 25, 25, 11, 25, 25, 25, 25, 25, 25, 25, 25, 25, 25, 25, 11, 25, 25, 25, 25, 25, 25, 25, 25, 25, 25, 25, 25, 25, 25, 25, 25, 25, 25, 25, 25, 25, 25, 25, 10,
      9, 25, 25, 25, 12, 22, 22, 22, 22, 22, 22, 22, 22, 22, 22, 22, 2, 25, 25, 25, 6, 25, 25, 25, 16, 25, 25, 25, 6, 25, 25, 25, 21, 22, 22, 22, 22, 22, 22, 22, 13, 25, 25, 25, 16, 25, 25, 25, 12, 22, 22, 22, 23, 25, 25, 25, 11, 25, 25, 25, 21, 22, 22, 22, 7, 22, 22, 22, 23, 25, 25, 25, 12, 22, 22, 22, 23, 25, 25, 25, 10,
      9, 25, 25, 25, 11, 25, 25, 25, 25, 25, 25, 25, 25, 25, 25, 25, 11, 25, 25, 25, 11, 25, 25, 25, 25, 25, 25, 25, 11, 25, 25, 25, 25, 25, 25, 25, 25, 25, 25, 25, 11, 25, 25, 25, 25, 25, 25, 25, 11, 25, 25, 25, 25, 25, 25, 25, 11, 25, 25, 25, 25, 25, 25, 25, 11, 25, 25, 25, 25, 25, 25, 25, 11, 25, 25, 25, 25, 25, 25, 25, 10,
      9, 25, 25, 25, 11, 25, 25, 25, 25, 25, 25, 25, 25, 25, 25, 25, 11, 25, 25, 25, 11, 25, 25, 25, 25, 25, 25, 25, 11, 25, 25, 25, 25, 25, 25, 25, 25, 25, 25, 25, 11, 25, 25, 25, 25, 25, 25, 25, 11, 25, 25, 25, 25, 25, 25, 25, 11, 25, 25, 25, 25, 25, 25, 25, 11, 25, 25, 25, 25, 25, 25, 25, 11, 25, 25, 25, 25, 25, 25, 25, 10,
      9, 25, 25, 25, 11, 25, 25, 25, 25, 25, 25, 25, 25, 25, 25, 25, 11, 25, 25, 25, 11, 25, 25, 25, 25, 25, 25, 25, 11, 25, 25, 25, 25, 25, 25, 25, 25, 25, 25, 25, 11, 25, 25, 25, 25, 25, 25, 25, 11, 25, 25, 25, 25, 25, 25, 25, 11, 25, 25, 25, 25, 25, 25, 25, 11, 25, 25, 25, 25, 25, 25, 25, 11, 25, 25, 25, 25, 25, 25, 25, 10,
      9, 25, 25, 25, 11, 25, 25, 25, 12, 22, 22, 22, 23, 25, 25, 25, 8, 22, 22, 22, 3, 22, 22, 22, 22, 22, 22, 22, 1, 22, 22, 22, 7, 22, 22, 22, 23, 25, 25, 25, 17, 22, 22, 22, 22, 22, 22, 22, 2, 25, 25, 25, 21, 22, 22, 22, 3, 22, 22, 22, 23, 25, 25, 25, 11, 25, 25, 25, 21, 22, 22, 22, 3, 22, 22, 22, 22, 22, 22, 23, 10,
      9, 25, 25, 25, 11, 26, 25, 25, 11, 25, 25, 25, 25, 25, 25, 25, 11, 25, 25, 25, 25, 25, 25, 25, 25, 25, 25, 25, 11, 25, 25, 25, 11, 25, 25, 25, 25, 25, 25, 25, 25, 25, 25, 25, 25, 25, 25, 25, 11, 25, 25, 25, 25, 25, 25, 25, 25, 25, 25, 25, 25, 25, 25, 25, 11, 25, 25, 25, 25, 25, 25, 25, 25, 25, 25, 25, 25, 25, 25, 25, 10,
      9, 25, 25, 25, 11, 25, 25, 25, 11, 25, 25, 25, 25, 25, 25, 25, 11, 25, 25, 25, 25, 25, 25, 25, 25, 25, 25, 25, 11, 25, 25, 25, 11, 25, 25, 25, 25, 25, 25, 25, 25, 25, 25, 25, 25, 25, 25, 25, 11, 25, 25, 25, 25, 25, 25, 25, 25, 25, 25, 25, 25, 25, 25, 25, 11, 25, 25, 25, 25, 25, 25, 25, 25, 25, 25, 25, 25, 25, 25, 25, 10,
      9, 25, 25, 25, 11, 25, 25, 25, 11, 25, 25, 25, 25, 25, 25, 25, 11, 25, 25, 25, 25, 25, 25, 25, 25, 25, 25, 25, 11, 25, 25, 25, 11, 25, 25, 25, 25, 25, 25, 25, 25, 25, 25, 25, 25, 25, 25, 25, 11, 25, 25, 25, 25, 25, 25, 25, 25, 25, 25, 25, 25, 25, 25, 25, 11, 25, 25, 25, 25, 25, 25, 25, 25, 25, 25, 25, 25, 25, 25, 25, 10,
      9, 25, 25, 25, 11, 25, 25, 25, 11, 25, 25, 25, 12, 22, 22, 22, 18, 25, 25, 25, 21, 22, 22, 22, 13, 25, 25, 25, 16, 25, 25, 25, 16, 25, 25, 25, 12, 22, 22, 22, 22, 22, 22, 22, 13, 25, 25, 25, 17, 22, 22, 22, 7, 22, 22, 22, 7, 22, 22, 22, 22, 22, 22, 22, 18, 25, 25, 25, 12, 22, 22, 22, 22, 22, 22, 22, 13, 25, 25, 25, 10,
      9, 25, 25, 25, 11, 25, 25, 25, 11, 25, 25, 25, 11, 25, 25, 25, 25, 25, 25, 25, 25, 25, 25, 25, 11, 25, 25, 25, 25, 25, 25, 25, 25, 25, 25, 25, 11, 25, 25, 25, 25, 25, 25, 25, 11, 25, 25, 25, 25, 25, 25, 25, 11, 25, 25, 25, 11, 25, 25, 25, 25, 25, 25, 25, 25, 25, 25, 25, 11, 25, 25, 25, 25, 25, 25, 25, 11, 25, 25, 25, 10,
      9, 25, 25, 25, 11, 26, 25, 25, 11, 25, 25, 25, 11, 25, 25, 25, 25, 25, 25, 25, 25, 25, 25, 25, 11, 25, 25, 25, 25, 25, 25, 25, 25, 25, 25, 25, 11, 25, 25, 25, 25, 25, 25, 25, 11, 25, 25, 25, 25, 25, 25, 25, 11, 25, 25, 25, 11, 25, 25, 25, 25, 25, 25, 25, 25, 25, 25, 25, 11, 25, 25, 25, 25, 25, 25, 25, 11, 25, 25, 25, 10,
      9, 25, 25, 25, 11, 25, 25, 25, 11, 25, 25, 25, 11, 25, 25, 26, 25, 25, 25, 25, 25, 26, 25, 25, 11, 25, 25, 25, 25, 25, 25, 25, 25, 25, 25, 25, 11, 25, 25, 25, 25, 25, 25, 25, 11, 25, 25, 25, 25, 25, 25, 25, 11, 25, 25, 25, 11, 25, 25, 25, 25, 25, 25, 25, 25, 25, 25, 25, 11, 25, 25, 25, 25, 25, 25, 25, 11, 25, 25, 25, 10,
      9, 25, 25, 25, 11, 25, 25, 25, 11, 25, 25, 25, 17, 22, 22, 22, 22, 22, 22, 22, 13, 25, 25, 25, 8, 22, 22, 22, 22, 22, 22, 22, 22, 22, 22, 22, 18, 25, 25, 25, 6, 25, 25, 25, 17, 22, 22, 22, 23, 25, 25, 25, 16, 25, 25, 25, 11, 25, 25, 25, 12, 22, 22, 22, 22, 22, 22, 22, 2, 25, 25, 25, 21, 22, 22, 22, 18, 25, 25, 25, 10,
      9, 25, 25, 25, 11, 25, 25, 25, 11, 25, 25, 25, 25, 25, 25, 25, 25, 25, 25, 25, 11, 25, 25, 25, 11, 25, 25, 25, 25, 25, 25, 25, 25, 25, 25, 25, 25, 25, 25, 25, 11, 25, 25, 25, 25, 25, 25, 25, 25, 25, 25, 25, 25, 25, 25, 25, 11, 25, 25, 25, 11, 25, 25, 25, 25, 25, 25, 25, 11, 25, 25, 25, 25, 25, 25, 25, 25, 25, 25, 25, 10,
      9, 25, 25, 25, 11, 25, 25, 25, 11, 25, 25, 25, 25, 25, 25, 25, 25, 25, 25, 25, 11, 25, 25, 25, 11, 25, 25, 25, 25, 25, 25, 25, 25, 25, 25, 25, 25, 25, 25, 25, 11, 25, 25, 25, 25, 25, 25, 25, 25, 25, 25, 25, 25, 25, 25, 25, 11, 25, 25, 25, 11, 25, 25, 25, 25, 25, 25, 25, 11, 25, 25, 25, 25, 25, 25, 25, 25, 25, 25, 25, 10,
      9, 25, 25, 25, 11, 26, 25, 25, 11, 25, 25, 25, 25, 25, 25, 25, 25, 25, 25, 25, 11, 25, 25, 25, 11, 25, 25, 25, 25, 25, 25, 25, 25, 25, 25, 25, 25, 25, 25, 25, 11, 25, 25, 25, 25, 25, 25, 25, 25, 25, 25, 25, 25, 25, 25, 25, 11, 25, 25, 25, 11, 25, 25, 25, 25, 25, 25, 25, 11, 25, 25, 25, 25, 25, 25, 25, 25, 25, 25, 25, 10,
      9, 25, 25, 25, 11, 25, 25, 25, 17, 22, 22, 22, 7, 22, 22, 22, 22, 22, 22, 22, 18, 25, 25, 25, 11, 25, 25, 25, 12, 22, 22, 22, 22, 22, 22, 22, 23, 25, 25, 25, 11, 25, 25, 25, 12, 22, 22, 22, 23, 25, 25, 25, 12, 22, 22, 22, 18, 25, 25, 25, 11, 25, 25, 25, 6, 25, 25, 25, 17, 22, 22, 22, 22, 22, 22, 22, 7, 22, 22, 23, 10,
      9, 25, 25, 25, 11, 25, 25, 25, 25, 25, 25, 25, 11, 25, 25, 25, 25, 25, 25, 25, 25, 25, 25, 25, 11, 25, 25, 25, 11, 25, 25, 25, 25, 25, 25, 25, 25, 25, 25, 25, 11, 25, 25, 25, 11, 25, 25, 25, 25, 25, 25, 25, 11, 25, 25, 25, 25, 25, 25, 25, 11, 25, 25, 25, 11, 25, 25, 25, 25, 25, 25, 25, 25, 25, 25, 25, 11, 25, 25, 25, 10,
      9, 25, 25, 25, 11, 25, 25, 25, 25, 25, 25, 25, 11, 25, 25, 25, 25, 25, 25, 25, 25, 25, 25, 25, 11, 25, 25, 25, 11, 25, 25, 25, 25, 25, 25, 25, 25, 25, 25, 25, 11, 25, 25, 25, 11, 25, 25, 25, 25, 25, 25, 25, 11, 25, 25, 25, 25, 25, 25, 25, 11, 25, 25, 25, 11, 25, 25, 25, 25, 25, 25, 25, 25, 25, 25, 25, 11, 25, 25, 25, 10,
      9, 25, 25, 25, 11, 25, 25, 25, 25, 25, 25, 25, 11, 25, 25, 25, 25, 25, 25, 25, 25, 25, 25, 25, 11, 25, 25, 25, 11, 25, 25, 25, 25, 25, 25, 25, 25, 25, 25, 25, 11, 25, 25, 25, 11, 25, 25, 25, 25, 25, 25, 25, 11, 25, 25, 25, 25, 25, 25, 25, 11, 25, 25, 25, 11, 25, 25, 25, 25, 25, 25, 25, 25, 25, 25, 25, 11, 25, 25, 24, 10,
      9, 25, 25, 25, 17, 22, 22, 22, 13, 25, 25, 25, 16, 25, 25, 25, 12, 22, 22, 22, 22, 22, 22, 22, 2, 25, 25, 25, 11, 25, 25, 25, 12, 22, 22, 22, 22, 22, 22, 22, 2, 25, 25, 25, 17, 22, 22, 22, 22, 22, 22, 22, 2, 25, 25, 25, 21, 22, 22, 22, 2, 25, 25, 25, 8, 22, 22, 22, 22, 22, 22, 22, 23, 25, 25, 25, 11, 25, 25, 25, 10,
      9, 25, 25, 25, 25, 25, 25, 25, 11, 25, 25, 25, 25, 25, 25, 25, 11, 25, 25, 25, 25, 25, 25, 25, 11, 25, 25, 25, 11, 25, 25, 25, 11, 25, 25, 25, 25, 25, 25, 25, 11, 25, 25, 25, 25, 25, 25, 25, 25, 25, 25, 25, 11, 25, 25, 25, 25, 25, 25, 25, 11, 25, 25, 25, 11, 25, 25, 25, 25, 25, 25, 25, 25, 25, 25, 25, 11, 25, 25, 25, 10,
      9, 25, 25, 25, 25, 25, 25, 25, 11, 25, 25, 25, 25, 25, 25, 25, 11, 25, 25, 25, 25, 25, 25, 25, 11, 25, 24, 25, 11, 25, 25, 25, 11, 25, 25, 25, 25, 25, 25, 25, 11, 25, 25, 25, 25, 25, 25, 25, 25, 25, 25, 25, 11, 25, 25, 25, 25, 25, 25, 25, 11, 25, 25, 25, 11, 25, 25, 25, 25, 25, 25, 25, 25, 25, 25, 25, 11, 25, 25, 25, 10,
      9, 25, 25, 25, 25, 25, 25, 25, 11, 25, 25, 25, 25, 25, 25, 25, 11, 25, 25, 25, 25, 25, 25, 25, 11, 25, 25, 25, 11, 25, 25, 25, 11, 25, 25, 25, 25, 25, 25, 25, 11, 25, 25, 25, 25, 25, 25, 25, 25, 25, 25, 25, 11, 25, 25, 25, 25, 25, 25, 25, 11, 25, 25, 25, 11, 25, 25, 25, 25, 25, 25, 25, 25, 25, 25, 25, 11, 25, 25, 25, 10,
      9, 25, 25, 25, 21, 22, 22, 22, 3, 22, 22, 22, 13, 25, 25, 25, 11, 25, 25, 25, 6, 25, 25, 25, 17, 22, 22, 22, 18, 25, 25, 25, 11, 25, 25, 25, 6, 25, 25, 25, 17, 22, 22, 22, 7, 22, 22, 22, 23, 26, 25, 25, 17, 22, 22, 22, 22, 22, 22, 22, 18, 25, 25, 25, 11, 25, 25, 25, 21, 22, 22, 22, 13, 25, 25, 25, 16, 25, 25, 25, 10,
      9, 25, 25, 25, 25, 25, 25, 25, 25, 25, 25, 25, 11, 25, 25, 25, 11, 25, 25, 25, 11, 25, 25, 25, 25, 25, 25, 25, 25, 25, 25, 25, 11, 25, 25, 25, 11, 25, 25, 25, 25, 25, 25, 25, 11, 25, 25, 25, 25, 25, 25, 25, 25, 25, 25, 25, 25, 25, 25, 25, 25, 25, 25, 25, 11, 25, 25, 25, 25, 25, 25, 25, 11, 25, 25, 25, 25, 25, 25, 25, 10,
      9, 25, 25, 25, 25, 25, 25, 25, 25, 25, 25, 25, 11, 25, 25, 25, 11, 25, 25, 25, 11, 25, 25, 25, 25, 25, 25, 25, 25, 25, 25, 25, 11, 25, 25, 25, 11, 25, 25, 25, 25, 25, 25, 25, 11, 25, 25, 25, 25, 25, 25, 25, 25, 25, 25, 25, 25, 25, 25, 25, 25, 25, 25, 25, 11, 25, 25, 25, 25, 25, 25, 25, 11, 25, 25, 25, 25, 25, 25, 26, 10,
      9, 25, 25, 25, 25, 25, 25, 25, 25, 25, 25, 25, 11, 25, 25, 25, 11, 25, 25, 25, 11, 25, 25, 25, 25, 25, 25, 25, 25, 25, 25, 25, 11, 25, 25, 25, 11, 25, 25, 25, 25, 25, 25, 25, 11, 25, 25, 25, 25, 25, 25, 25, 25, 25, 25, 25, 25, 25, 25, 25, 25, 25, 25, 25, 11, 25, 25, 25, 25, 25, 25, 25, 11, 25, 25, 25, 25, 25, 25, 25, 10,
      9, 21, 22, 22, 22, 22, 22, 22, 13, 25, 25, 25, 16, 25, 25, 25, 11, 25, 25, 25, 17, 22, 22, 22, 7, 22, 22, 22, 22, 22, 22, 22, 2, 25, 25, 25, 17, 22, 22, 22, 13, 25, 25, 25, 17, 22, 22, 22, 22, 22, 22, 22, 22, 22, 22, 22, 22, 22, 22, 22, 22, 22, 22, 22, 3, 22, 22, 22, 13, 25, 25, 25, 17, 22, 22, 22, 13, 25, 25, 25, 10,
      9, 25, 25, 25, 25, 25, 25, 25, 11, 25, 25, 25, 25, 25, 25, 25, 11, 25, 25, 25, 25, 25, 25, 25, 11, 25, 25, 25, 25, 25, 25, 25, 11, 25, 25, 25, 25, 25, 25, 25, 11, 25, 25, 25, 25, 25, 25, 25, 25, 25, 25, 25, 25, 25, 25, 25, 25, 25, 25, 25, 25, 25, 25, 25, 25, 25, 25, 25, 11, 25, 25, 25, 25, 25, 25, 25, 11, 25, 25, 25, 10,
      9, 25, 25, 25, 25, 25, 25, 25, 11, 25, 25, 25, 25, 25, 25, 25, 11, 25, 25, 25, 25, 25, 25, 25, 11, 25, 25, 25, 25, 25, 25, 25, 11, 25, 25, 25, 25, 25, 25, 25, 11, 25, 25, 25, 25, 25, 25, 25, 25, 25, 25, 25, 25, 25, 25, 25, 25, 25, 25, 25, 25, 25, 25, 25, 25, 25, 25, 25, 11, 25, 25, 25, 25, 25, 25, 25, 11, 25, 25, 25, 10,
      9, 25, 25, 25, 25, 25, 25, 25, 11, 25, 25, 25, 25, 25, 25, 25, 11, 25, 25, 25, 25, 25, 25, 25, 11, 25, 25, 25, 25, 25, 25, 25, 11, 25, 25, 25, 25, 25, 25, 25, 11, 25, 25, 25, 25, 25, 25, 25, 25, 25, 25, 25, 25, 25, 25, 25, 25, 25, 25, 25, 25, 25, 25, 25, 25, 25, 25, 25, 11, 25, 25, 25, 25, 25, 25, 25, 11, 25, 25, 25, 10,
      9, 24, 25, 25, 6, 25, 25, 25, 17, 22, 22, 22, 22, 22, 22, 22, 1, 22, 22, 22, 23, 25, 25, 25, 11, 25, 25, 25, 12, 22, 22, 22, 3, 22, 22, 22, 13, 25, 25, 25, 17, 22, 22, 22, 7, 22, 22, 22, 22, 22, 22, 22, 7, 22, 22, 22, 22, 22, 22, 22, 23, 25, 25, 25, 6, 25, 25, 25, 8, 22, 22, 22, 23, 25, 25, 25, 11, 25, 25, 25, 10,
      9, 25, 25, 25, 11, 25, 25, 25, 25, 25, 25, 25, 25, 25, 25, 25, 11, 25, 25, 25, 25, 25, 25, 25, 11, 25, 25, 25, 11, 25, 25, 25, 25, 25, 25, 25, 11, 25, 25, 25, 25, 25, 25, 25, 11, 25, 25, 25, 25, 25, 25, 25, 11, 25, 25, 25, 25, 25, 25, 25, 25, 25, 25, 25, 11, 25, 25, 25, 11, 25, 25, 25, 25, 25, 25, 25, 11, 25, 25, 25, 10,
      9, 25, 25, 25, 11, 25, 25, 25, 25, 25, 25, 25, 25, 25, 25, 25, 11, 25, 25, 25, 25, 25, 25, 25, 11, 25, 25, 25, 11, 25, 25, 25, 25, 25, 25, 25, 11, 25, 25, 25, 25, 25, 25, 25, 11, 25, 25, 25, 25, 25, 25, 25, 11, 25, 25, 25, 25, 25, 25, 25, 25, 25, 25, 25, 11, 25, 25, 25, 11, 25, 25, 25, 25, 25, 25, 25, 11, 25, 25, 25, 10,
      9, 25, 25, 25, 11, 25, 25, 25, 25, 25, 25, 25, 25, 25, 25, 25, 11, 25, 25, 25, 25, 25, 25, 25, 11, 25, 25, 25, 11, 25, 25, 25, 25, 25, 25, 25, 11, 25, 25, 25, 25, 25, 25, 25, 11, 25, 25, 25, 25, 25, 25, 25, 11, 25, 25, 25, 25, 25, 25, 25, 25, 25, 25, 25, 11, 25, 25, 25, 11, 25, 25, 25, 25, 25, 25, 25, 11, 25, 25, 25, 10,
      9, 21, 22, 22, 3, 22, 22, 22, 22, 22, 22, 22, 23, 25, 25, 25, 11, 25, 25, 25, 12, 22, 22, 22, 18, 25, 25, 25, 11, 25, 25, 25, 6, 25, 25, 25, 17, 22, 22, 22, 13, 25, 25, 25, 11, 25, 25, 25, 6, 25, 25, 25, 11, 25, 25, 25, 12, 22, 22, 22, 22, 22, 22, 22, 18, 25, 25, 25, 11, 25, 25, 25, 12, 22, 22, 22, 18, 25, 25, 25, 10,
      9, 25, 25, 25, 25, 25, 25, 25, 25, 25, 25, 25, 25, 25, 25, 25, 11, 25, 25, 25, 11, 25, 25, 25, 25, 25, 25, 25, 11, 25, 25, 25, 11, 25, 25, 25, 25, 25, 25, 25, 11, 25, 25, 25, 11, 25, 25, 25, 11, 25, 25, 25, 11, 25, 25, 25, 11, 25, 25, 25, 25, 25, 25, 25, 25, 25, 25, 25, 11, 25, 25, 25, 11, 25, 25, 25, 25, 25, 25, 25, 10,
      9, 25, 25, 25, 25, 25, 25, 25, 25, 25, 25, 25, 25, 25, 25, 25, 11, 25, 25, 25, 11, 25, 25, 25, 25, 25, 25, 25, 11, 25, 25, 25, 11, 25, 25, 25, 25, 25, 25, 25, 11, 25, 25, 25, 11, 25, 25, 25, 11, 25, 25, 25, 11, 25, 25, 25, 11, 25, 25, 25, 25, 25, 25, 25, 25, 25, 25, 25, 11, 25, 25, 25, 11, 25, 25, 25, 25, 25, 25, 25, 10,
      9, 25, 25, 25, 25, 25, 25, 25, 25, 25, 25, 25, 25, 25, 25, 25, 11, 25, 25, 25, 11, 25, 25, 25, 25, 25, 25, 25, 11, 25, 25, 25, 11, 25, 25, 25, 25, 25, 25, 25, 11, 25, 25, 25, 11, 25, 25, 25, 11, 25, 25, 25, 11, 25, 25, 25, 11, 25, 25, 25, 25, 25, 25, 25, 25, 25, 25, 25, 11, 25, 25, 25, 11, 25, 25, 25, 25, 25, 25, 25, 10,
      9, 25, 25, 25, 21, 22, 22, 22, 22, 22, 22, 22, 22, 22, 22, 22, 18, 25, 25, 25, 11, 25, 25, 25, 21, 22, 22, 22, 18, 25, 25, 25, 17, 22, 22, 22, 22, 22, 22, 22, 18, 25, 25, 25, 11, 25, 25, 25, 11, 25, 25, 25, 17, 22, 22, 22, 18, 25, 25, 25, 21, 22, 22, 22, 7, 22, 22, 22, 18, 25, 25, 25, 11, 25, 25, 25, 21, 22, 22, 23, 10,
      9, 25, 25, 25, 25, 25, 25, 25, 25, 25, 25, 25, 25, 25, 25, 25, 25, 25, 25, 25, 11, 25, 25, 25, 25, 25, 25, 25, 25, 25, 25, 25, 25, 25, 25, 25, 25, 25, 25, 25, 25, 25, 25, 25, 11, 25, 25, 25, 11, 25, 25, 25, 25, 25, 25, 25, 25, 25, 25, 25, 25, 25, 25, 25, 11, 25, 25, 25, 25, 25, 25, 25, 11, 25, 25, 25, 25, 25, 25, 25, 10,
      9, 25, 25, 25, 25, 25, 25, 25, 25, 25, 25, 25, 25, 25, 25, 25, 25, 25, 25, 25, 11, 25, 25, 25, 25, 25, 25, 25, 25, 25, 25, 25, 25, 25, 25, 25, 25, 25, 25, 25, 25, 25, 25, 25, 11, 25, 25, 25, 11, 25, 25, 25, 25, 25, 25, 25, 25, 25, 25, 25, 25, 25, 25, 25, 11, 25, 25, 25, 25, 25, 25, 25, 11, 25, 25, 25, 25, 25, 25, 25, 10,
      9, 25, 25, 25, 25, 25, 25, 25, 25, 25, 25, 25, 25, 25, 25, 25, 25, 25, 25, 25, 11, 25, 25, 25, 25, 25, 25, 25, 25, 25, 25, 25, 25, 25, 25, 25, 25, 25, 25, 25, 25, 25, 25, 25, 11, 25, 25, 25, 11, 25, 25, 25, 25, 25, 25, 25, 25, 25, 25, 25, 25, 25, 25, 25, 11, 25, 25, 25, 25, 25, 25, 25, 11, 25, 25, 25, 25, 25, 25, 25, 10,
      9, 21, 22, 22, 22, 22, 22, 22, 7, 22, 22, 22, 13, 25, 25, 25, 12, 22, 22, 22, 3, 22, 22, 22, 7, 22, 22, 22, 22, 22, 22, 22, 22, 22, 22, 22, 22, 22, 22, 22, 22, 22, 22, 22, 3, 22, 22, 22, 18, 25, 25, 25, 12, 22, 22, 22, 22, 22, 22, 22, 13, 25, 25, 25, 11, 25, 25, 25, 21, 22, 22, 22, 3, 22, 22, 22, 13, 25, 25, 25, 10,
      9, 25, 25, 25, 25, 25, 25, 25, 11, 25, 25, 25, 11, 25, 25, 25, 11, 25, 25, 25, 25, 25, 25, 25, 11, 25, 25, 25, 25, 25, 25, 25, 25, 25, 25, 25, 25, 25, 25, 25, 25, 25, 25, 25, 25, 25, 25, 25, 25, 25, 25, 25, 11, 25, 25, 25, 25, 25, 25, 25, 11, 25, 25, 25, 11, 25, 25, 25, 25, 25, 25, 25, 25, 25, 25, 25, 11, 25, 25, 25, 10,
      9, 25, 25, 25, 25, 25, 25, 25, 11, 25, 25, 25, 11, 25, 25, 25, 11, 25, 25, 25, 25, 25, 25, 25, 11, 25, 25, 25, 25, 25, 25, 25, 25, 25, 25, 25, 25, 25, 25, 25, 25, 25, 25, 25, 25, 25, 25, 25, 25, 25, 25, 25, 11, 25, 25, 25, 25, 25, 25, 25, 11, 25, 25, 25, 11, 25, 25, 25, 25, 25, 25, 25, 25, 25, 25, 25, 11, 25, 25, 25, 10,
      9, 25, 25, 25, 25, 25, 25, 25, 11, 25, 25, 25, 11, 25, 25, 25, 11, 25, 25, 25, 25, 25, 25, 25, 11, 25, 25, 25, 25, 25, 25, 25, 25, 25, 25, 25, 25, 25, 25, 25, 25, 25, 25, 25, 25, 25, 25, 25, 25, 25, 25, 25, 11, 25, 25, 25, 25, 25, 25, 25, 11, 25, 25, 25, 11, 25, 25, 25, 25, 25, 25, 25, 25, 25, 25, 25, 11, 25, 25, 25, 10,
      9, 25, 25, 25, 6, 25, 25, 25, 16, 25, 25, 25, 11, 25, 25, 25, 16, 25, 25, 25, 6, 25, 25, 25, 11, 25, 25, 25, 12, 22, 22, 22, 7, 22, 22, 22, 22, 22, 22, 22, 7, 22, 22, 22, 22, 22, 22, 22, 22, 22, 22, 22, 2, 25, 24, 25, 6, 25, 25, 25, 11, 25, 25, 25, 8, 22, 22, 22, 22, 22, 22, 22, 13, 25, 25, 25, 17, 22, 22, 23, 10,
      9, 25, 25, 25, 11, 25, 25, 25, 25, 25, 25, 25, 11, 25, 25, 25, 25, 25, 25, 25, 11, 25, 25, 25, 11, 25, 25, 25, 11, 25, 25, 25, 11, 25, 25, 25, 25, 25, 25, 25, 11, 25, 25, 25, 25, 25, 25, 25, 25, 25, 25, 25, 11, 25, 25, 25, 11, 25, 25, 25, 11, 25, 25, 25, 11, 25, 25, 25, 25, 25, 25, 25, 11, 25, 25, 25, 25, 25, 25, 25, 10,
      9, 25, 25, 25, 11, 25, 25, 25, 25, 25, 25, 25, 11, 25, 25, 25, 25, 25, 25, 25, 11, 25, 25, 25, 11, 25, 25, 25, 11, 25, 25, 25, 11, 25, 25, 25, 25, 25, 25, 25, 11, 25, 25, 25, 25, 25, 25, 25, 25, 25, 25, 25, 11, 25, 25, 25, 11, 25, 26, 25, 11, 25, 25, 25, 11, 25, 25, 25, 25, 25, 25, 25, 11, 25, 25, 25, 25, 25, 25, 25, 10,
      9, 25, 25, 25, 11, 25, 25, 25, 25, 25, 25, 25, 11, 25, 25, 25, 25, 25, 25, 25, 11, 25, 25, 25, 11, 25, 25, 25, 11, 25, 25, 25, 11, 25, 25, 25, 25, 25, 25, 25, 11, 25, 25, 25, 25, 25, 25, 25, 25, 25, 25, 25, 11, 25, 25, 25, 11, 25, 25, 25, 11, 25, 25, 25, 11, 25, 25, 25, 25, 25, 25, 25, 11, 25, 25, 25, 25, 25, 25, 25, 10,
      9, 25, 25, 25, 17, 22, 22, 22, 13, 25, 25, 25, 17, 22, 22, 22, 7, 22, 22, 22, 18, 25, 25, 25, 11, 25, 25, 25, 16, 25, 25, 25, 11, 25, 25, 25, 6, 25, 25, 25, 16, 25, 25, 25, 12, 22, 22, 22, 13, 25, 25, 25, 17, 22, 22, 22, 18, 25, 25, 25, 17, 22, 22, 22, 18, 25, 25, 25, 6, 25, 25, 25, 17, 22, 22, 22, 13, 25, 25, 25, 10,
      9, 25, 25, 25, 25, 25, 25, 25, 11, 25, 25, 25, 25, 25, 25, 25, 11, 25, 25, 25, 25, 25, 25, 25, 11, 25, 25, 25, 25, 25, 25, 25, 11, 25, 25, 25, 11, 25, 25, 25, 25, 25, 25, 25, 11, 25, 25, 25, 11, 25, 25, 25, 25, 25, 25, 25, 25, 25, 25, 25, 25, 25, 25, 25, 25, 25, 25, 25, 11, 25, 25, 25, 25, 25, 25, 25, 11, 25, 25, 25, 10,
      9, 25, 25, 25, 25, 25, 25, 25, 11, 25, 25, 25, 25, 25, 25, 25, 11, 25, 25, 25, 25, 25, 25, 25, 11, 25, 25, 25, 25, 25, 25, 25, 11, 25, 25, 25, 11, 25, 25, 25, 25, 25, 25, 25, 11, 25, 25, 25, 11, 25, 25, 25, 25, 25, 25, 25, 25, 25, 25, 25, 25, 25, 25, 25, 25, 25, 25, 25, 11, 25, 25, 25, 25, 25, 25, 25, 11, 25, 25, 25, 10,
      9, 25, 25, 25, 25, 25, 25, 25, 11, 25, 25, 25, 25, 25, 25, 25, 11, 25, 25, 25, 25, 25, 25, 25, 11, 25, 25, 25, 25, 25, 25, 25, 11, 25, 25, 25, 11, 25, 25, 25, 25, 25, 25, 25, 11, 25, 25, 25, 11, 25, 25, 25, 25, 25, 25, 25, 25, 25, 25, 25, 25, 25, 25, 25, 25, 25, 25, 25, 11, 25, 25, 25, 25, 25, 25, 25, 11, 25, 25, 25, 10,
      9, 21, 22, 22, 13, 25, 25, 25, 17, 22, 22, 22, 13, 25, 25, 25, 16, 25, 25, 25, 21, 22, 22, 22, 3, 22, 22, 22, 23, 25, 25, 25, 11, 25, 25, 25, 8, 22, 22, 22, 22, 22, 22, 22, 2, 25, 25, 25, 17, 22, 22, 22, 22, 22, 22, 22, 22, 22, 22, 22, 22, 22, 22, 22, 7, 22, 22, 22, 3, 22, 22, 22, 23, 25, 25, 25, 11, 25, 25, 25, 10,
      9, 25, 25, 25, 11, 25, 25, 25, 25, 25, 25, 25, 11, 25, 25, 25, 25, 25, 25, 25, 25, 25, 25, 25, 25, 25, 25, 25, 25, 25, 25, 25, 11, 25, 25, 25, 11, 25, 25, 25, 25, 25, 25, 25, 11, 25, 25, 25, 25, 25, 25, 25, 25, 25, 25, 25, 25, 25, 25, 25, 25, 25, 25, 25, 11, 25, 25, 25, 25, 25, 25, 25, 25, 25, 25, 25, 11, 25, 25, 25, 10,
      9, 25, 25, 25, 11, 25, 25, 25, 25, 25, 25, 25, 11, 25, 25, 25, 25, 25, 25, 25, 25, 25, 25, 25, 25, 25, 25, 25, 25, 25, 25, 25, 11, 25, 25, 25, 11, 25, 25, 25, 25, 25, 25, 25, 11, 25, 25, 25, 25, 25, 25, 25, 25, 25, 25, 25, 25, 25, 25, 25, 25, 25, 25, 25, 11, 25, 25, 25, 25, 25, 25, 25, 25, 25, 25, 25, 11, 25, 25, 25, 10,
      9, 25, 25, 25, 11, 25, 25, 25, 25, 25, 25, 25, 11, 25, 25, 25, 25, 25, 25, 25, 25, 25, 25, 25, 25, 25, 25, 25, 25, 25, 25, 25, 11, 25, 25, 25, 11, 25, 25, 25, 25, 25, 25, 25, 11, 25, 25, 25, 25, 25, 25, 25, 25, 25, 25, 25, 25, 25, 25, 25, 25, 25, 25, 25, 11, 25, 25, 25, 25, 25, 25, 25, 25, 25, 25, 25, 11, 25, 25, 25, 10,
      9, 25, 25, 25, 8, 22, 22, 22, 22, 22, 22, 22, 3, 22, 22, 22, 7, 22, 22, 22, 13, 25, 25, 25, 12, 22, 22, 22, 22, 22, 22, 22, 18, 25, 25, 25, 8, 22, 22, 22, 23, 25, 25, 25, 17, 22, 22, 22, 13, 25, 25, 25, 12, 22, 22, 22, 22, 22, 22, 22, 13, 25, 25, 25, 16, 25, 25, 25, 12, 22, 22, 22, 22, 22, 22, 22, 2, 25, 25, 25, 10,
      9, 25, 25, 25, 11, 25, 25, 25, 25, 25, 25, 25, 25, 25, 25, 25, 11, 25, 25, 25, 11, 25, 25, 25, 11, 25, 25, 25, 25, 25, 25, 25, 25, 25, 25, 25, 11, 25, 25, 25, 25, 25, 25, 25, 25, 25, 25, 26, 11, 25, 25, 25, 11, 25, 25, 25, 25, 25, 25, 25, 11, 25, 25, 25, 25, 25, 25, 25, 11, 25, 25, 25, 25, 25, 25, 25, 11, 25, 25, 25, 10,
      9, 25, 25, 25, 11, 25, 25, 25, 25, 25, 25, 25, 25, 25, 25, 25, 11, 25, 25, 25, 11, 25, 25, 25, 11, 25, 25, 25, 25, 25, 25, 25, 25, 25, 25, 25, 11, 25, 25, 25, 25, 25, 25, 25, 25, 25, 25, 25, 11, 25, 25, 25, 11, 25, 25, 25, 25, 25, 25, 25, 11, 25, 25, 25, 25, 25, 25, 25, 11, 25, 25, 25, 25, 25, 25, 25, 11, 25, 25, 25, 10,
      9, 25, 25, 25, 11, 25, 25, 25, 25, 25, 25, 25, 25, 25, 25, 25, 11, 25, 25, 25, 11, 25, 25, 25, 11, 25, 25, 25, 25, 25, 25, 25, 25, 25, 25, 25, 11, 25, 25, 25, 25, 25, 25, 25, 25, 25, 25, 25, 11, 25, 25, 25, 11, 25, 25, 25, 25, 25, 25, 25, 11, 25, 25, 25, 25, 25, 25, 25, 11, 25, 25, 25, 25, 25, 25, 25, 11, 25, 25, 25, 10,
      9, 25, 25, 25, 16, 25, 25, 25, 12, 22, 22, 22, 23, 25, 25, 25, 11, 25, 25, 25, 16, 25, 25, 25, 11, 25, 25, 25, 21, 22, 22, 22, 22, 22, 22, 22, 2, 26, 25, 25, 21, 22, 22, 22, 13, 25, 25, 25, 11, 25, 25, 25, 11, 25, 25, 25, 21, 22, 22, 22, 3, 22, 22, 22, 22, 22, 22, 22, 18, 25, 25, 25, 6, 25, 25, 25, 11, 25, 25, 25, 10,
      9, 25, 25, 25, 25, 25, 25, 25, 11, 25, 25, 25, 25, 25, 25, 25, 11, 25, 25, 25, 25, 25, 25, 25, 11, 25, 25, 25, 25, 25, 25, 25, 25, 25, 25, 25, 11, 25, 25, 25, 25, 25, 25, 25, 11, 25, 25, 25, 11, 25, 25, 25, 11, 25, 25, 25, 25, 25, 25, 25, 25, 25, 25, 25, 25, 25, 25, 25, 25, 25, 25, 25, 11, 25, 25, 25, 11, 25, 25, 25, 10,
      9, 25, 25, 25, 25, 25, 25, 25, 11, 25, 25, 25, 25, 25, 25, 25, 11, 25, 25, 25, 25, 25, 25, 25, 11, 25, 25, 25, 25, 25, 25, 25, 25, 25, 25, 25, 11, 25, 25, 25, 25, 25, 25, 25, 11, 25, 25, 25, 11, 25, 25, 25, 11, 25, 25, 25, 25, 25, 26, 25, 25, 25, 25, 25, 25, 25, 25, 25, 25, 25, 25, 25, 11, 25, 25, 25, 11, 25, 25, 25, 10,
      9, 25, 25, 25, 25, 25, 25, 25, 11, 25, 25, 25, 25, 25, 25, 25, 11, 25, 25, 25, 25, 25, 25, 25, 11, 25, 25, 25, 25, 25, 25, 25, 25, 25, 25, 25, 11, 25, 25, 25, 25, 25, 25, 25, 11, 25, 25, 25, 11, 25, 25, 25, 11, 25, 25, 25, 25, 25, 25, 25, 25, 25, 25, 25, 25, 25, 25, 25, 25, 25, 25, 25, 11, 25, 25, 25, 11, 25, 25, 25, 10,
      9, 21, 22, 22, 23, 25, 25, 25, 11, 25, 25, 25, 12, 22, 22, 22, 18, 25, 25, 25, 21, 22, 22, 22, 3, 22, 22, 22, 22, 22, 22, 22, 13, 25, 25, 25, 8, 22, 22, 22, 23, 25, 25, 25, 11, 25, 25, 25, 16, 25, 25, 25, 17, 22, 22, 22, 22, 22, 22, 22, 13, 25, 25, 25, 6, 25, 26, 25, 6, 25, 26, 25, 11, 25, 25, 25, 16, 25, 25, 25, 10,
      9, 25, 25, 25, 25, 25, 25, 25, 11, 25, 25, 25, 11, 25, 25, 25, 25, 25, 25, 25, 25, 25, 25, 25, 25, 25, 25, 25, 25, 25, 25, 25, 11, 25, 25, 25, 11, 25, 25, 25, 25, 25, 25, 25, 11, 25, 25, 25, 25, 25, 25, 25, 25, 25, 25, 25, 25, 25, 25, 25, 11, 25, 25, 25, 11, 25, 25, 25, 11, 25, 25, 25, 11, 25, 25, 25, 25, 25, 25, 25, 10,
      9, 25, 25, 25, 25, 25, 25, 25, 11, 25, 25, 25, 11, 25, 25, 25, 25, 25, 25, 25, 25, 25, 25, 25, 25, 25, 25, 25, 25, 25, 25, 25, 11, 25, 25, 25, 11, 25, 25, 25, 25, 25, 25, 25, 11, 25, 25, 25, 25, 25, 25, 25, 25, 25, 25, 25, 25, 25, 25, 25, 11, 25, 25, 25, 11, 25, 25, 25, 11, 25, 25, 25, 11, 25, 25, 25, 25, 25, 25, 25, 10,
      9, 25, 25, 25, 25, 25, 25, 25, 11, 25, 25, 25, 11, 25, 25, 25, 25, 25, 25, 25, 25, 25, 25, 25, 25, 25, 25, 25, 25, 25, 25, 25, 11, 25, 25, 25, 11, 25, 25, 25, 25, 25, 25, 25, 11, 25, 25, 25, 25, 25, 25, 25, 25, 25, 25, 25, 25, 25, 25, 25, 11, 25, 25, 25, 11, 25, 25, 25, 11, 25, 25, 25, 11, 25, 25, 25, 25, 25, 25, 25, 10,
      9, 25, 25, 25, 21, 22, 22, 22, 3, 22, 22, 22, 18, 25, 25, 25, 12, 22, 22, 22, 22, 22, 22, 22, 22, 22, 22, 22, 23, 25, 25, 25, 11, 25, 25, 25, 17, 22, 22, 22, 22, 22, 22, 22, 2, 25, 25, 25, 6, 25, 25, 25, 21, 22, 22, 22, 13, 25, 25, 25, 16, 25, 25, 25, 11, 25, 25, 25, 11, 25, 25, 25, 17, 22, 22, 22, 22, 22, 22, 23, 10,
      9, 25, 25, 25, 25, 25, 25, 25, 25, 25, 25, 25, 25, 25, 25, 25, 11, 25, 25, 25, 25, 25, 25, 25, 25, 25, 25, 25, 25, 25, 25, 25, 11, 25, 25, 25, 25, 25, 25, 25, 25, 25, 25, 25, 11, 25, 25, 25, 11, 25, 25, 25, 25, 25, 25, 25, 11, 25, 25, 25, 25, 25, 25, 25, 11, 25, 25, 25, 11, 25, 25, 25, 25, 25, 25, 25, 25, 25, 25, 25, 10,
      9, 25, 25, 25, 25, 25, 25, 25, 25, 25, 25, 25, 25, 25, 25, 25, 11, 25, 25, 25, 25, 25, 25, 25, 25, 25, 25, 25, 25, 25, 25, 25, 11, 25, 25, 25, 25, 25, 25, 25, 25, 25, 25, 25, 11, 25, 25, 25, 11, 25, 25, 25, 25, 25, 25, 25, 11, 25, 25, 25, 25, 25, 25, 25, 11, 25, 25, 25, 11, 25, 25, 25, 25, 25, 25, 25, 25, 25, 24, 25, 10,
      9, 25, 25, 25, 25, 25, 25, 25, 25, 25, 25, 25, 25, 25, 25, 25, 16, 25, 25, 25, 25, 25, 25, 25, 25, 25, 25, 25, 25, 25, 25, 25, 16, 25, 25, 25, 25, 25, 25, 25, 25, 25, 25, 25, 11, 25, 25, 25, 16, 25, 25, 25, 25, 25, 25, 25, 16, 25, 25, 25, 25, 25, 25, 25, 16, 25, 25, 25, 16, 25, 25, 25, 25, 25, 25, 25, 25, 25, 25, 25, 10,
      14, 19, 19, 19, 19, 19, 19, 19, 19, 19, 19, 19, 19, 19, 19, 19, 19, 19, 19, 19, 19, 19, 19, 19, 19, 19, 19, 19, 19, 19, 19, 19, 19, 19, 19, 19, 19, 19, 19, 19, 19, 25, 25, 25, 14, 19, 19, 19, 19, 19, 19, 19, 19, 19, 19, 19, 19, 19, 19, 19, 19, 19, 19, 19, 19, 19, 19, 19, 19, 19, 19, 19, 19, 19, 19, 19, 19, 19, 19, 19, 15
    ]
}
